{
	"attack_combos":[
		"Q,Q,Q",
		"Q,Q,W",
		"Q,Q,E",
		"Q,Q,A",
		"Q,Q,S",
		"Q,Q,D",
		"Q,W,Q",
		"Q,W,W",
		"Q,W,E",
		"Q,W,A",
		"Q,W,S",
		"Q,W,D",
		"Q,E,Q",
		"Q,E,W",
		"Q,E,E",
		"Q,E,A",
		"Q,E,S",
		"Q,E,D",
		"Q,A,Q",
		"Q,A,W",
		"Q,A,E",
		"Q,A,A",
		"Q,A,S",
		"Q,A,D",
		"Q,S,Q",
		"Q,S,W",
		"Q,S,E",
		"Q,S,A",
		"Q,S,S",
		"Q,S,D",
		"Q,D,Q",
		"Q,D,W",
		"Q,D,E",
		"Q,D,A",
		"Q,D,S",
		"Q,D,D",
		"W,Q,Q",
		"W,Q,W",
		"W,Q,E",
		"W,Q,A",
		"W,Q,S",
		"W,Q,D",
		"W,W,Q",
		"W,W,W",
		"W,W,E",
		"W,W,A",
		"W,W,S",
		"W,W,D",
		"W,E,Q",
		"W,E,W",
		"W,E,E",
		"W,E,A",
		"W,E,S",
		"W,E,D",
		"W,A,Q",
		"W,A,W",
		"W,A,E",
		"W,A,A",
		"W,A,S",
		"W,A,D",
		"W,S,Q",
		"W,S,W",
		"W,S,E",
		"W,S,A",
		"W,S,S",
		"W,S,D",
		"W,D,Q",
		"W,D,W",
		"W,D,E",
		"W,D,A",
		"W,D,S",
		"W,D,D",
		"E,Q,Q",
		"E,Q,W",
		"E,Q,E",
		"E,Q,A",
		"E,Q,S",
		"E,Q,D",
		"E,W,Q",
		"E,W,W",
		"E,W,E",
		"E,W,A",
		"E,W,S",
		"E,W,D",
		"E,E,Q",
		"E,E,W",
		"E,E,E",
		"E,E,A",
		"E,E,S",
		"E,E,D",
		"E,A,Q",
		"E,A,W",
		"E,A,E",
		"E,A,A",
		"E,A,S",
		"E,A,D",
		"E,S,Q",
		"E,S,W",
		"E,S,E",
		"E,S,A",
		"E,S,S",
		"E,S,D",
		"E,D,Q",
		"E,D,W",
		"E,D,E",
		"E,D,A",
		"E,D,S",
		"E,D,D",
		"A,Q,Q",
		"A,Q,W",
		"A,Q,E",
		"A,Q,A",
		"A,Q,S",
		"A,Q,D",
		"A,W,Q",
		"A,W,W",
		"A,W,E",
		"A,W,A",
		"A,W,S",
		"A,W,D",
		"A,E,Q",
		"A,E,W",
		"A,E,E",
		"A,E,A",
		"A,E,S",
		"A,E,D",
		"A,A,Q",
		"A,A,W",
		"A,A,E",
		"A,A,A",
		"A,A,S",
		"A,A,D",
		"A,S,Q",
		"A,S,W",
		"A,S,E",
		"A,S,A",
		"A,S,S",
		"A,S,D",
		"A,D,Q",
		"A,D,W",
		"A,D,E",
		"A,D,A",
		"A,D,S",
		"A,D,D",
		"S,Q,Q",
		"S,Q,W",
		"S,Q,E",
		"S,Q,A",
		"S,Q,S",
		"S,Q,D",
		"S,W,Q",
		"S,W,W",
		"S,W,E",
		"S,W,A",
		"S,W,S",
		"S,W,D",
		"S,E,Q",
		"S,E,W",
		"S,E,E",
		"S,E,A",
		"S,E,S",
		"S,E,D",
		"S,A,Q",
		"S,A,W",
		"S,A,E",
		"S,A,A",
		"S,A,S",
		"S,A,D",
		"S,S,Q",
		"S,S,W",
		"S,S,E",
		"S,S,A",
		"S,S,S",
		"S,S,D",
		"S,D,Q",
		"S,D,W",
		"S,D,E",
		"S,D,A",
		"S,D,S",
		"S,D,D",
		"D,Q,Q",
		"D,Q,W",
		"D,Q,E",
		"D,Q,A",
		"D,Q,S",
		"D,Q,D",
		"D,W,Q",
		"D,W,W",
		"D,W,E",
		"D,W,A",
		"D,W,S",
		"D,W,D",
		"D,E,Q",
		"D,E,W",
		"D,E,E",
		"D,E,A",
		"D,E,S",
		"D,E,D",
		"D,A,Q",
		"D,A,W",
		"D,A,E",
		"D,A,A",
		"D,A,S",
		"D,A,D",
		"D,S,Q",
		"D,S,W",
		"D,S,E",
		"D,S,A",
		"D,S,S",
		"D,S,D",
		"D,D,Q",
		"D,D,W",
		"D,D,E",
		"D,D,A",
		"D,D,S",
		"D,D,D"
		]
}